...###
..#..#.#.#.
.##..###..#
##...##...#
#...@..#..#
#.#...##..#
..#..#....#
.##.##.###.
.#.##...##
.#.....##
.##.##..