...###.....
..##.#...#.
.##..###..#
##........#
#...@#.#..#
.##.#..#..#
..#..#.#..#
.##.##.#.##
.#.##...##.
.#.....##..
.###..##...